XXXXXXXXXXXXXXXXXXXXX
XOOOXOOOOOXOOOOOOOXOX
XXXOXXXOXOXOXXXXXOXOX
XOXOOOXOXOXOOOXOXOOOX
XOXXXOXOXOXXXOXOXXXOX
XOXOOOXOXOOOOOXOXOOOX
XOXOXXXOXXXXXXXOXOXXX
XOXOXOOOXOOOOOOOXOXOX
XOXOXOXXXXXOXXXXXOXOX
XOOOXOXOOOOOXOOOOOXOX
XOXXXOXXXOXOXOXXXXXOX
XOXOOOXOOOXOXOXOOOOOX
XOXOXXXOXOXXXOXOXXXOX
XOOOXOOOXOXOOOXOOOXOX
XXXXXOXOXXXOXXXXXOXOX
XOOOXOXOOOOOXOOOOOXOX
XOXXXOXXXXXXXXXXXXXOX
XOXOOOXOOOOOXOOOOOOOX
XOXOXXXOXXXOXOXXXXXOX
XOOOOOOOXOOOOOXFOOOOX
XXXXXXXXXXXXXXXXXXXXX
